10.ox
...oo.oo..
....o.....
......oo..
o......o..
.o..o...o.
.o........
....o...o.
..o....oo.
..o..ooo..
.o....oo..
